1.891968169986839440e-03,-6.423487707897201915e-01,-9.071609107137121666e-03,7.663564334104506770e-01,2.974517863647034854e-01,1.073345693205821849e+00,6.372506523366899822e-01
1.679430381878290477e-03,-6.270395679188017768e-01,-9.007860118858573503e-03,7.789335133590503668e-01,3.381304402952132193e-01,1.074929685366043719e+00,5.693003970830838867e-01
1.639804282417403180e-03,-6.194331494265723492e-01,-8.995260172839750906e-03,7.849961590529064281e-01,3.571837768678072234e-01,1.075684379072738173e+00,5.352862898156480753e-01
1.298513206858877738e-03,-6.034869826480546706e-01,-8.945200777410650117e-03,7.973216157993272546e-01,3.941432832367878225e-01,1.077470189689691882e+00,4.632997535803290989e-01
1.179430198248310321e-03,-5.950557099195898925e-01,-8.873022144629283750e-03,8.036346063445261034e-01,4.122159611579063188e-01,1.078373963498187038e+00,4.256518852458987534e-01
1.367120559516426127e-03,-5.865760732912811415e-01,-8.922029805115463605e-03,8.098438359385802254e-01,4.298512171320688635e-01,1.078763037907163547e+00,3.874444749945669120e-01
1.222177626804733840e-03,-5.779041288885253813e-01,-8.644137388061075983e-03,8.160579654560449203e-01,4.472568942719311602e-01,1.079680164104656281e+00,3.476711192818516816e-01
1.176536930231607400e-03,-5.698866006082619062e-01,-8.825337743478857411e-03,8.216751131814354903e-01,4.622586641990234502e-01,1.080326717547355209e+00,3.098192019259681795e-01
1.216822023074938660e-03,-5.622660866016323533e-01,-8.887998966452035840e-03,8.269077159370459285e-01,4.764914865442516634e-01,1.080927910078686605e+00,2.721796357256287546e-01
1.150968156160299362e-03,-5.550098596339934076e-01,-8.818253744076099201e-03,8.317962306852944021e-01,4.896783435377678462e-01,1.081695977918984974e+00,2.337844302703434851e-01
1.143323473424412429e-03,-5.477948923796345237e-01,-8.827421845786040389e-03,8.365653144362227289e-01,5.025256097443718817e-01,1.082355141813119426e+00,1.943364372337023638e-01
1.245544289654560658e-03,-5.406437868662749002e-01,-8.780739062537882070e-03,8.412048757370774732e-01,5.152226113561222398e-01,1.082931832361140989e+00,1.537926771750637023e-01
1.298310293587920687e-03,-5.339052623775479844e-01,-8.810555631217492634e-03,8.454974034882736245e-01,5.266379660636411053e-01,1.083611691612991867e+00,1.125348439707747339e-01
1.438443633356917880e-03,-5.276973148068490049e-01,-8.904446346277829216e-03,8.493845923142362420e-01,5.377918412023305894e-01,1.084194142531928806e+00,7.130519229039705698e-02
1.166829321749678853e-03,-5.212314396305574027e-01,-8.697659460169320997e-03,8.533702453038222169e-01,5.485328618541096546e-01,1.085200888975400568e+00,2.909991890544849635e-02
1.458283911941252869e-03,-5.140897689268572046e-01,-8.771925048685956169e-03,8.576902915526694038e-01,5.592811644281462380e-01,1.085584762856476315e+00,-1.192865996789446714e-02
1.392797326268544172e-03,-5.070419321754812136e-01,-8.781000813076386344e-03,8.618755322876286984e-01,5.689805211936465046e-01,1.086320356152872035e+00,-5.157661988864525870e-02
1.493075479479399068e-03,-4.999152690836164425e-01,-8.730381709280740643e-03,8.660290265908401341e-01,5.781028737835589570e-01,1.086910506797727827e+00,-9.003270399388579870e-02
1.443461851874219652e-03,-4.923138898692014931e-01,-8.625611257569932439e-03,8.703737984855537402e-01,5.864443309801509185e-01,1.087569855600044821e+00,-1.291051764101500410e-01
1.424732523387805270e-03,-4.845443572177781655e-01,-8.362127594864850536e-03,8.747255631612318449e-01,5.946822528573749711e-01,1.088180164769606773e+00,-1.693525645630613308e-01
1.500550520585584640e-03,-4.754609736429025735e-01,-8.381507209329739153e-03,8.796956071435040325e-01,6.023364490936956583e-01,1.088720416529229018e+00,-2.114145177603631298e-01
1.388885901341982464e-03,-4.646649537468476310e-01,-8.383884824431349012e-03,8.854457985843310341e-01,6.092886464214575248e-01,1.089413298290598853e+00,-2.567609415089471270e-01
1.117447958300874129e-03,-4.526823911881469042e-01,-8.090248567192400223e-03,8.916344272718292885e-01,6.150634122647822277e-01,1.090325900907869183e+00,-3.044048552585731926e-01
9.709824598314910349e-04,-4.406228252370223419e-01,-7.863231155108368897e-03,8.976573693057995351e-01,6.197088209157401995e-01,1.090948391751455970e+00,-3.519785239214758277e-01
1.440797135452076827e-01,-3.409579242115630682e-01,-6.246053697704544855e-02,9.268696841426049549e-01,7.479054877085211661e-01,9.922106020706739082e-01,5.074783122040897876e-01
1.657223964975873265e-01,-4.097018638980055028e-01,-1.179314494604793845e-01,8.892539812931664622e-01,5.796673061498579527e-01,8.622332774662455623e-01,7.454835658477789728e-01
1.633271375209039145e-01,-4.304328343451392924e-01,-1.185552665688666685e-01,8.797706917348534494e-01,5.485391713419996984e-01,8.579498441816608700e-01,7.733609111838817274e-01
1.616981803594999545e-01,-4.529831469127435506e-01,-1.203349046857104254e-01,8.684350740243829136e-01,5.128134089411341412e-01,8.503299902066864258e-01,8.055626817869723233e-01
1.611124434501364500e-01,-4.745775249554606279e-01,-1.215984762599945923e-01,8.567571207430512148e-01,4.768871434611154370e-01,8.401831196361390086e-01,8.360670283201321329e-01
1.618274551896955460e-01,-4.954444430938008126e-01,-1.211281707143830183e-01,8.447926638020052392e-01,4.406254731546625503e-01,8.296427670338218929e-01,8.637220582785628542e-01
1.625710457503394268e-01,-5.149797591075617742e-01,-1.232749396348598453e-01,8.325681906313623371e-01,3.963960530581812081e-01,8.166718739269405170e-01,8.912104873627444412e-01
1.625525618229691216e-01,-5.336434402439441671e-01,-1.256807485095677301e-01,8.203692417341550414e-01,3.456269172938303269e-01,8.071097924293320069e-01,9.138331230154106422e-01
1.591364991035428278e-01,-5.744019728869874664e-01,-1.222100620863182524e-01,7.936010640879099798e-01,2.314457791854937774e-01,8.147540412109535168e-01,9.337020533110553799e-01
3.662726113272872230e-01,-3.597902067500238221e-01,-3.087268249650954588e-01,8.006766693648793565e-01,5.365167099414095420e-01,1.133675938323288057e-01,8.117858393879205936e-01
3.767486494022021515e-01,-3.691721954240066994e-01,-3.211410235515322897e-01,7.865372135453666536e-01,4.965354500318620579e-01,5.142380505919244560e-02,8.212801474622568598e-01
3.832250509275045292e-01,-3.779759209741161419e-01,-3.263782826535754356e-01,7.770135006018126234e-01,4.654197225368971735e-01,1.660902936401136357e-02,8.263252411517341134e-01
3.813988884487587994e-01,-3.841062448196306267e-01,-3.265768788655982191e-01,7.748192194125140819e-01,4.482703358063638843e-01,1.609261352030760123e-02,8.284731530496066698e-01
3.693281951579158728e-01,-3.869741532667354544e-01,-3.245243648628190480e-01,7.800843708056671710e-01,4.428246709295531325e-01,4.771927601009006564e-02,8.319697489422147596e-01
3.484228683708874286e-01,-3.868617993058187099e-01,-3.204202760029136177e-01,7.913724153395065297e-01,4.448991519298819974e-01,1.065779168862011766e-01,8.345842633509736874e-01
2.916078505052395742e-01,-5.812104297597320279e-01,-2.121372400509139999e-01,7.294909795506743233e-01,-3.195323478598421918e-02,5.614499799517808087e-01,8.302024124943880867e-01
4.431342635825642473e-01,-4.467558628889101158e-01,-2.812987502856080235e-01,7.245082722103861617e-01,1.469973148878705171e-01,8.417686181887527874e-02,8.302026356102831794e-01
4.539880373285847259e-01,-4.547859661221006489e-01,-2.915049749276712454e-01,7.085826956490998141e-01,1.019481303258253646e-01,3.789035977356818019e-02,8.224355340497208067e-01
4.564772457594269417e-01,-4.601911551351234309e-01,-3.086665301033273412e-01,6.961160808609869743e-01,5.541861692746274937e-02,-6.727811202807184449e-03,8.116071319692209629e-01
4.511214813315190808e-01,-4.619829004820579232e-01,-3.317407512288816362e-01,6.877567031425707578e-01,1.126878933883934675e-02,-5.092630460742171572e-02,7.960825183006486894e-01
4.358677524438627215e-01,-4.611359047728040284e-01,-3.587446787887446642e-01,6.845985941773935490e-01,-2.725999250310662259e-02,-8.896133193675138939e-02,7.769313166910216673e-01
